ICE
11,2

WWWWWWWWWWWWW
WFFFFFFFFFFFW
WFFFFFFFFFFFW
WEFFFFFFFFFFW
WWWWWWWWWWWWW
