RAINBOW
26,3

WWWWWWWWWWWWWWWWWWWWWWWWWWWW
WFFFFFHHHFHHHFHFHFHFHHHFFHHW
WFHFHHFFHFFFFFFFFFFFFFFFFFFW
WFFFFFFFFFFFFFFFFFFFFFFFFFFW
WFFHFHHHFHHHHHHHHHHHHHHHHHHW
WFFFHFFHFHHFHFHHHFFFHFFHFHHW
WFFFFFFHEHFFHFFFHFFFFFFFFFHW
WWWWWWWWWWWWWWWWWWWWWWWWWWWW
