DARK
11,2

WWWWWWWWWWWWW
WFFFFFFFFFFFW
WEFFFFFFFFFFW
WFFFFFFFFFFFW
WWWWWWWWWWWWW
